11Jungle.map
C:\Lessons\DIGITAL WORKS\ProjectK\Data\Map
0
0
12
1,-128,-128,9
0,0,0,1,1,1,1,1,1,
0,0,0,0,0,0,0,0,0,
0,-96,-192,9
1,1,0,0,1,1,1,0,0,
0,0,0,0,0,0,0,0,0,
0,0,-192,1
1,
0,
0,-32,-192,1
1,
0,
1,192,-160,8
3,3,3,3,3,3,3,3,
0,0,0,0,0,0,0,0,
3,-128,-256,19
1,1,1,1,1,1,1,1,1,1,1,1,1,1,1,1,1,1,1,
0,0,0,0,0,0,0,0,0,0,0,0,0,0,0,0,0,0,0,
1,0,-448,8
0,0,3,3,3,3,3,0,
0,0,0,0,0,0,0,0,
3,0,-448,9
3,3,3,3,3,3,3,3,3,
0,0,0,0,0,0,0,0,0,
1,224,-224,11
3,3,3,3,3,3,3,3,3,3,3,
0,0,0,0,0,0,0,0,0,0,0,
1,576,64,16
1,1,1,1,1,1,1,1,1,1,1,1,1,1,1,1,
0,0,0,0,0,0,0,0,0,0,0,0,0,0,0,0,
1,32,-576,10
3,3,3,3,3,3,3,3,3,3,
0,0,0,0,0,0,0,0,0,0,
3,0,-640,13
1,1,1,1,1,1,1,1,1,1,1,1,1,
0,0,0,0,0,0,0,0,0,0,0,0,0,
7
1
-39,-342
2
353,39,1
2
424,110,1
2
309,20,1
2
85,139,1
2
336,-216,1
4
-74,
